county,candidate,early_vote,electday_vote,absentee_vote,total_vote,reporting
Allegany,Larry  Hogan and Boyd K. Rutherford,2055,15993,1176,19224,37 of 37
Allegany,Ben  Jealous and Susan  Turnbull,516,2689,780,3985,37 of 37
Allegany,Shawn  Quinn and Christina  Smith,12,136,18,166,37 of 37
Allegany,Ian  Schlakman and Annie  Chambers,17,100,22,139,37 of 37
Allegany,Other Write-Ins,2,13,1,16,37 of 37
Anne Arundel,Larry  Hogan and Boyd K. Rutherford,44549,103436,9217,157202,195 of 195
Anne Arundel,Ben  Jealous and Susan  Turnbull,23891,39497,6011,69399,195 of 195
Anne Arundel,Shawn  Quinn and Christina  Smith,318,913,135,1366,195 of 195
Anne Arundel,Ian  Schlakman and Annie  Chambers,315,619,118,1052,195 of 195
Anne Arundel,Other Write-Ins,60,113,14,187,195 of 195
Baltimore City,Larry  Hogan and Boyd K. Rutherford,14937,39208,4215,58360,296 of 296
Baltimore City,Ben  Jealous and Susan  Turnbull,32098,81160,10351,123609,296 of 296
Baltimore City,Shawn  Quinn and Christina  Smith,236,717,102,1055,296 of 296
Baltimore City,Ian  Schlakman and Annie  Chambers,358,1005,128,1491,296 of 296
Baltimore City,Other Write-Ins,41,119,16,176,296 of 296
Baltimore,Larry  Hogan and Boyd K. Rutherford,59150,128960,10102,198212,236 of 236
Baltimore,Ben  Jealous and Susan  Turnbull,41257,72308,9298,122863,236 of 236
Baltimore,Shawn  Quinn and Christina  Smith,384,1142,152,1678,236 of 236
Baltimore,Ian  Schlakman and Annie  Chambers,434,930,218,1582,236 of 236
Baltimore,Other Write-Ins,82,161,58,301,236 of 236
Calvert,Larry  Hogan and Boyd K. Rutherford,6176,21923,1511,29610,23 of 23
Calvert,Ben  Jealous and Susan  Turnbull,2484,5968,764,9216,23 of 23
Calvert,Shawn  Quinn and Christina  Smith,51,237,15,303,23 of 23
Calvert,Ian  Schlakman and Annie  Chambers,26,98,6,130,23 of 23
Calvert,Other Write-Ins,5,17,3,25,23 of 23
Caroline,Larry  Hogan and Boyd K. Rutherford,2544,6622,323,9489,8 of 8
Caroline,Ben  Jealous and Susan  Turnbull,514,1281,105,1900,8 of 8
Caroline,Shawn  Quinn and Christina  Smith,19,58,5,82,8 of 8
Caroline,Ian  Schlakman and Annie  Chambers,9,18,1,28,8 of 8
Caroline,Other Write-Ins,3,3,0,6,8 of 8
Carroll,Larry  Hogan and Boyd K. Rutherford,13525,46689,2231,62445,36 of 36
Carroll,Ben  Jealous and Susan  Turnbull,3127,7704,936,11767,36 of 36
Carroll,Shawn  Quinn and Christina  Smith,99,414,20,533,36 of 36
Carroll,Ian  Schlakman and Annie  Chambers,74,173,14,261,36 of 36
Carroll,Other Write-Ins,10,32,3,45,36 of 36
Cecil,Larry  Hogan and Boyd K. Rutherford,5831,20340,892,27063,28 of 28
Cecil,Ben  Jealous and Susan  Turnbull,1887,5024,443,7354,28 of 28
Cecil,Shawn  Quinn and Christina  Smith,60,277,16,353,28 of 28
Cecil,Ian  Schlakman and Annie  Chambers,25,116,13,154,28 of 28
Cecil,Other Write-Ins,3,12,0,15,28 of 28
Charles,Larry  Hogan and Boyd K. Rutherford,7873,22421,1462,31756,43 of 43
Charles,Ben  Jealous and Susan  Turnbull,8628,21646,1826,32100,43 of 43
Charles,Shawn  Quinn and Christina  Smith,47,208,19,274,43 of 43
Charles,Ian  Schlakman and Annie  Chambers,54,119,20,193,43 of 43
Charles,Other Write-Ins,7,27,3,37,43 of 43
Dorchester,Larry  Hogan and Boyd K. Rutherford,2132,6589,484,9205,39 of 39
Dorchester,Ben  Jealous and Susan  Turnbull,849,1995,199,3043,39 of 39
Dorchester,Shawn  Quinn and Christina  Smith,13,52,7,72,39 of 39
Dorchester,Ian  Schlakman and Annie  Chambers,12,23,4,39,39 of 39
Dorchester,Other Write-Ins,3,4,1,8,39 of 39
Frederick,Larry  Hogan and Boyd K. Rutherford,14590,54499,3471,72560,79 of 79
Frederick,Ben  Jealous and Susan  Turnbull,8871,21422,3062,33355,79 of 79
Frederick,Shawn  Quinn and Christina  Smith,119,576,51,746,79 of 79
Frederick,Ian  Schlakman and Annie  Chambers,101,350,48,499,79 of 79
Frederick,Other Write-Ins,9,47,3,59,79 of 79
Garrett,Larry  Hogan and Boyd K. Rutherford,2286,6661,525,9472,19 of 19
Garrett,Ben  Jealous and Susan  Turnbull,468,755,172,1395,19 of 19
Garrett,Shawn  Quinn and Christina  Smith,15,66,5,86,19 of 19
Garrett,Ian  Schlakman and Annie  Chambers,11,35,2,48,19 of 19
Garrett,Other Write-Ins,3,4,0,7,19 of 19
Harford,Larry  Hogan and Boyd K. Rutherford,26802,55658,2799,85259,86 of 86
Harford,Ben  Jealous and Susan  Turnbull,8665,13895,1452,24012,86 of 86
Harford,Shawn  Quinn and Christina  Smith,186,527,43,756,86 of 86
Harford,Ian  Schlakman and Annie  Chambers,141,283,37,461,86 of 86
Harford,Other Write-Ins,35,53,3,91,86 of 86
Howard,Larry  Hogan and Boyd K. Rutherford,24620,52290,3664,80574,118 of 118
Howard,Ben  Jealous and Susan  Turnbull,21808,34926,4412,61146,118 of 118
Howard,Shawn  Quinn and Christina  Smith,171,569,60,800,118 of 118
Howard,Ian  Schlakman and Annie  Chambers,216,472,64,752,118 of 118
Howard,Other Write-Ins,41,63,7,111,118 of 118
Kent,Larry  Hogan and Boyd K. Rutherford,1998,4066,306,6370,10 of 10
Kent,Ben  Jealous and Susan  Turnbull,941,1118,163,2222,10 of 10
Kent,Shawn  Quinn and Christina  Smith,12,28,3,43,10 of 10
Kent,Ian  Schlakman and Annie  Chambers,21,34,2,57,10 of 10
Kent,Other Write-Ins,0,2,0,2,10 of 10
Montgomery,Larry  Hogan and Boyd K. Rutherford,45210,116654,18154,180018,255 of 255
Montgomery,Ben  Jealous and Susan  Turnbull,67582,130108,26339,224029,255 of 255
Montgomery,Shawn  Quinn and Christina  Smith,324,1352,246,1922,255 of 255
Montgomery,Ian  Schlakman and Annie  Chambers,520,1294,296,2110,255 of 255
Montgomery,Other Write-Ins,124,187,38,349,255 of 255
Prince George's,Larry  Hogan and Boyd K. Rutherford,30853,53012,6060,89925,274 of 274
Prince George's,Ben  Jealous and Susan  Turnbull,70630,139665,15594,225889,274 of 274
Prince George's,Shawn  Quinn and Christina  Smith,323,1018,128,1469,274 of 274
Prince George's,Ian  Schlakman and Annie  Chambers,437,888,98,1423,274 of 274
Prince George's,Other Write-Ins,112,146,21,279,274 of 274
Queen Anne's,Larry  Hogan and Boyd K. Rutherford,7451,11267,785,19503,11 of 11
Queen Anne's,Ben  Jealous and Susan  Turnbull,1473,1546,249,3268,11 of 11
Queen Anne's,Shawn  Quinn and Christina  Smith,25,69,5,99,11 of 11
Queen Anne's,Ian  Schlakman and Annie  Chambers,43,37,6,86,11 of 11
Queen Anne's,Other Write-Ins,9,4,2,15,11 of 11
St. Mary's,Larry  Hogan and Boyd K. Rutherford,7216,21971,1516,30703,36 of 36
St. Mary's,Ben  Jealous and Susan  Turnbull,2383,5870,831,9084,36 of 36
St. Mary's,Shawn  Quinn and Christina  Smith,61,316,33,410,36 of 36
St. Mary's,Ian  Schlakman and Annie  Chambers,33,118,19,170,36 of 36
St. Mary's,Other Write-Ins,5,20,2,27,36 of 36
Somerset,Larry  Hogan and Boyd K. Rutherford,1467,3456,280,5203,23 of 23
Somerset,Ben  Jealous and Susan  Turnbull,654,1330,395,2379,23 of 23
Somerset,Shawn  Quinn and Christina  Smith,15,47,9,71,23 of 23
Somerset,Ian  Schlakman and Annie  Chambers,10,20,3,33,23 of 23
Somerset,Other Write-Ins,5,11,0,16,23 of 23
Talbot,Larry  Hogan and Boyd K. Rutherford,6475,6881,725,14081,12 of 12
Talbot,Ben  Jealous and Susan  Turnbull,1912,1725,320,3957,12 of 12
Talbot,Shawn  Quinn and Christina  Smith,22,51,6,79,12 of 12
Talbot,Ian  Schlakman and Annie  Chambers,33,29,4,66,12 of 12
Talbot,Other Write-Ins,3,4,0,7,12 of 12
Washington,Larry  Hogan and Boyd K. Rutherford,6328,30286,2151,38765,53 of 53
Washington,Ben  Jealous and Susan  Turnbull,2239,7372,1283,10894,53 of 53
Washington,Shawn  Quinn and Christina  Smith,50,397,44,491,53 of 53
Washington,Ian  Schlakman and Annie  Chambers,37,195,36,268,53 of 53
Washington,Other Write-Ins,8,34,1,43,53 of 53
Wicomico,Larry  Hogan and Boyd K. Rutherford,6637,14789,1233,22659,54 of 54
Wicomico,Ben  Jealous and Susan  Turnbull,3247,6329,850,10426,54 of 54
Wicomico,Shawn  Quinn and Christina  Smith,58,196,30,284,54 of 54
Wicomico,Ian  Schlakman and Annie  Chambers,40,92,9,141,54 of 54
Wicomico,Other Write-Ins,7,15,2,24,54 of 54
Worcester,Larry  Hogan and Boyd K. Rutherford,5057,11868,1151,18076,20 of 20
Worcester,Ben  Jealous and Susan  Turnbull,1572,3477,388,5437,20 of 20
Worcester,Shawn  Quinn and Christina  Smith,25,111,12,148,20 of 20
Worcester,Ian  Schlakman and Annie  Chambers,16,59,7,82,20 of 20
Worcester,Other Write-Ins,6,5,1,12,20 of 20
